"filename", "language", "C++", "comment", "blank", "total"
"/home/diogop/N-Body_v2/src/barnesHutTree.cpp", "C++", 67, 3, 14, 84
"/home/diogop/N-Body_v2/src/barnesHutTree.hpp", "C++", 18, 1, 9, 28
"/home/diogop/N-Body_v2/src/gravitationalForce.cpp", "C++", 60, 3, 17, 80
"/home/diogop/N-Body_v2/src/gravitationalForce.hpp", "C++", 9, 1, 4, 14
"/home/diogop/N-Body_v2/src/initialState.cpp", "C++", 30, 1, 8, 39
"/home/diogop/N-Body_v2/src/initialState.hpp", "C++", 8, 1, 5, 14
"/home/diogop/N-Body_v2/src/main.cpp", "C++", 11, 92, 13, 116
"/home/diogop/N-Body_v2/src/main.hpp", "C++", 14, 1, 6, 21
"/home/diogop/N-Body_v2/src/output.cpp", "C++", 45, 7, 8, 60
"/home/diogop/N-Body_v2/src/output.hpp", "C++", 10, 1, 4, 15
"/home/diogop/N-Body_v2/src/rungeKutta.cpp", "C++", 33, 1, 10, 44
"/home/diogop/N-Body_v2/src/rungeKutta.hpp", "C++", 10, 1, 4, 15
"/home/diogop/N-Body_v2/src/structures.cpp", "C++", 1, 1, 3, 5
"/home/diogop/N-Body_v2/src/structures.hpp", "C++", 55, 1, 10, 66
"Total", "-", 371, 115, 115, 601